UUU	F
UCU	S
UAU	Y
UGU	C
UUC	F
UCC	S
UAC	Y
UGC	C
UUA	L
UCA	S
UAA	*
UGA	*
UUG	L
UCG	S
UAG	*
UGG	W
CUU	L
CCU	P
CAU	H
CGU	R
CUC	L
CCC	P
CAC	H